1111111111111111111111111111
100010C000000000000000000001
1000111000000000000E00000001
1P00000000000000000000100001
100000000000000C000000100001
100C000000000000000000100C01
1111111111111111111111111111