11111111111111111111111111111111111111
1P100010111011100000000000000000101111
10101011111111111111111111111111111011
100000000000000000010C0000010000001111
10111010111110100001000100010000111011
11111110111010100001000100010000001011
10001110111110100001000100010000111011
10101010111111100001000100010C00101011
11101110100010100001000100010000111001
1000C00C10101000000000010C0000000000E1
11111111111111111111111111111111111111